#######################x###########################################################################################################################################
#.#.#.#.#.#.#.#.#.#.#.#.#.#.#.#.#.#.#.#.#.#.#...#.#.#.#.#.#.#.#.#.#.#.#.#.#.#.#.#.....#.#.#.#...#.#.#.#...#...#.#...#.#.#.#.#...#...#.#.#.#.#.#...#.....#.#...#...#
#.#.#.#.#.#.#.#.#.#.#.#.#.#.#.#.#.#.#.#.#.#.#.#.#.#.#.#.#.#.#.#.#.#.#.#.#.#.#.#.#.#####.#.#.#.#.#.#.#.#.#.#.###.#.###.#.#.#.#.###.###.#.#.#.#.###.#.#####.###.#.###
#.#.#.....#...#...#.....#.#.........#.........#...#.............#...#...........#.#.......#...#.#.#.#...#...#.....#...#...#...............#.......................#
#.#.#.###.#.###.#######.#.###.#####.#.#.#.#####.#.#.#.#######.###.###.#######.#.#.#.#.#.#####.###.#.#.#.#####.#.###.#.###.#########.#######.###############.###.###
#.#...#...#.............#.#.#.....#.#.#.#.#...#.#...#...#...#...#.....###.###.#...#.#.#.........#.#...#...#...#.#...#...#.........#...###...###.......#...#...#...#
#.#####.###.#####.###.###.#.#.###.#.#.#.###.#.###.#####.#.###.###.#######.###.#####.#.#.#####.###.#######.#.###.#.#####.#########.###.###.#####.###.#.###.###.#####
#.#...#.#...#.....#...#...#...#...#.#.#...#.#...#.....#.#...#.....#.................#.#.....#.#.........#...#.#...#####.............#.....###...###.#...#.....#...y
#.#.###.#####.#########.#######.###.###.#####.#.#######.###.#######.#####.###########.#####.#.#.#######.#####.#.#########.#######.###########.#####.###.#####.#.###
#.#...#.....#.###.......###...#.#.#...#...#.#.#.........#...#.......###.#...#.......#.....#.#.#.#...#.#...#.....#########...#...#...#...###...###...###...#...#...#
#.###.#####.#.###.#########.#.#.#.###.###.#.#.#############.###########.###.#.###.#######.#.#.#.#.###.###.###.#############.###.#.###.#.###.#############.#.###.###
#...#.....#.#...#.#.......#.#...#.#...#...#...#.......#.......#.......#.....#.#...........#.#.#.#.......#.....#############...#...#...#.....#####.###.#.#...#.#...#
#.#.#.#.###.#.#.#.###.###.#.#####.#.###.###.###.#####.###.#.#.###.###.#######.###.#######.#.###.###.###.#####.###############.#####.#############.###.#.#####.###.#
#.#.#.#.....#.#.#.#.....#...#.#.....#.....#...#...#.#.#...#.#.....###.......#...#.#.....#.#.....#...#.....#...###############.......#####...#.###.......#####.....#
#.#.#.#########.#.###.#.#####.#.#######.#####.###.#.#.#####################.###.###.###.###.#####.###.#####.#############################.###.###.###.#########.###
#.#...#.....#...#.#...#.....#...###...#...#.#.#...#.#.#.#...###.......#.....#.....#.#.#.....#...#.#...#.....#############################.......#.###.....#####.#.#
#.#####.###.#.###.#######.#.#.#####.#.###.#.#.#.###.#.#.#.#.###.#####.#.#####.#####.#.#######.###.#.###.#####################################.#.#.#######.#####.###
#.#...#.#.#...#.#.......#.#.#...###.#.#...#...#.#.#.#.#.#.#.#...###...#...#...#...#.#.........#...#.#...###########.....................###...#...#######.........#
#.#.#.#.#.#.###.#######.###.###.###.#.#.#####.#.#.#.#.#.#.#.#.#####.#####.#.###.#.#.#######.###.#####.#############.###################.#####.###############.#####
#...#...#...#.#.........#...#.......#.#.....#...#.....#.#.#...###...#.....#.#...#...#.......#.....#...#############.###################...###...#######.....#.....#
#######.#####.#.#.#.###.#.###########.###.#.#####.#####.#.#######.###.#######.###.###.#######.#.###.###############.#####################.#############.###.#.#####
#.#...#.#.......#.#...#.#.#.....#...#...#.#.#...#.#.....#.#.###...#.....#...#...#.#...#.......#.#...###############.#######...###########...###########.###.#.....#
#.#.#.#.#.#############.#.#.###.###.###.###.#.###.#.#.###.#.###.#######.#.#.###.#.###.#.###.#.###.#################.#######.#.#############.###########.###.#.#####
#...#.....#.............#.....#...#.....#...#.#...#.#.......#...#...#.....#.....#.#...#.#.#.#.#...#################.###.....#...###########...#####.....###...#...#
#.#####.###.###################.#.###.#####.#.#.###.#########.###.#.#########.###.###.#.#.#.###.###################.###.#######.#############.#####.#########.#.###
#.#####.#...#.................#.#...#.......#.#.#.........#...###.#.......###...#.#.....#.#.....#######.........###.#...#######...###########.......#####.....#...#
#.#####.#.###.###########.#.#.#####.#.#######.#.#######.###.#######.#####.#######.###.###.#####.#######.#######.###.#.###########.#############.#########.#####.###
#.#...#.#.#.....#...#...#.#.#.#.....#.#...###.#.......#.#...#.....#...#.#...#...#...#.#.....#...#######.#######.###...###########...###########...#######...#.....#
#.#.#.#.#.#####.#.#.#.#.#####.###.###.#.#.###.#######.###.###.###.###.#.###.#.#.###.#.###.#.#.#########.#######.###################.#############.#########.#.#####
#...#.#.#.....#...#...#.....#...#...#.#.#...#.......#.....#.....#.........#.#.#.###.#...#.#.#.#.........#######.....#############...###########...#.....#...#.#...#
#####.#.#####.#############.###.#.#.#.#.###.#.#####.###########.#########.#.#.#.###.#.#.#.###.#.###################.#############.#############.###.###.#.###.#.###
#...#.#.#...#.....###.......#...#.#.#.#.###.#...#.#...#.......#.....#...#.#.#.#...#.#.#...#.#.#.###################...#########...###########...###...#...#...#...#
#.###.#.#.#.#####.#####.#####.#####.###.###.###.#.###.###.#.#.#.#.###.#.###.#.###.#.#####.#.#.#.#####################.#########.#############.#######.#####.###.###
#...#.#...#.#.#.#...###.#...........#...###.#.......#...#.#.#...#.#...#.....#.#...#...#...#...#...........###########...#####...###########...#####...#.....#...#.#
#.#.#.#.#####.#.###.###.#############.#####.#######.###.###.#######.#######.###.#####.###.###.###########.#############.#####.#############.#######.#.#.###.#.#.#.#
#.#...#...#...#...#...#.#.#...#.......#####.......#.#...........#...#...#.#...#.......#.....#.......#####.#############...#...###########...#######.#...###...#...#
###.###.#.#.###.###.#.#.#.#.#.#.#################.#.###.#.###.###.###.#.#.#.#.#######.###.#.#.###########.###############.#.#############.#########################
#.#.#.#.#.#...#...#.#.#.....#.#.#################.#...#.#...#.#...#...#.#...#...#.....#.#.#.#.#...........###############...###...#####...#################.......#
#.#.#.###.###.###.#.#.###.###.#.#################.#####.###.###.###.#####.#####.#.###.#.###.#.#.###############################.#.#####.###################.#######
#...#.....#...#.#...#.###.#.....#################.#.#...#.#.....#.#...#...#...#...#.#.#...#.#.#.#############################...#...#...#################...###...#
#.#.#.#####.###.###.#.#####.###.#################.#.#.###.#######.###.###.###.#####.#.#.###.#.#.#############################.#####.#.###################.#####.###
#.#.#.#.....#.....#.#.......#.#.#################.#...#.....#.........#...#...#.....#.#.....#.#.#########################.....#####...#################...#.......#
###.#.###.###.#.###.#########.#.#################.#.#####.#.#.###.#######.#.#####.#.#.#.#.###.#.###########################.###########################.###.#.#####
#.#.#...#...#.#.....#...#.......#################.#.......#...#...#.........#...#.#...#.#.#...#.###################.......#...#######################...#...#.#...#
#.#.###.###.#.#####.###.#.#######################.###########################.#.#.#####.#######.###################.#.###.###.#######################.#####.###.###
#...#...#...#.#.......#.#.#######################.........................###.#...#.#.#.#.......###################.#.#.....#...#####################.#...........#
###.###.#.###.#####.###.#.###############################################.###.#####.#.#.#.#########################.#.#####.###.#####################.###.###.#####
#...#...#.###.#...#.#.....#.....#########################################.###...#.#.....#.#########################.#.....#...#...###################.#...#.......#
###.#.###.###.#.#.#.#######.###.#########################################.#####.#.#.#####.###############################.###.###.###################.#########.###
#...#...#...#...#.#.#.......#.#.#########################################.#...#.#.....#...###############################...#...#...###########.......###.........#
#.#####.###.#####.#.#.#######.#.#########################################.#.#.#.#######.#################################.#.###.###.###########.#####.###.#.#######
#...#...#...#...#.#.#.#.........###############################...........#.#...#.......#################################.#...#...#...#######...#...#.#...#.......#
#.#.#.###.###.###.###.#####.###.###############################.###########.#####.###########################################.###.###.#######.###.###.###.#####.###
#.#.#.....###.....#.#.....#...#.....###########################.#...............#.###########################################...#.#...#######.#.#.....#...#...#...#
###.#.#######.#####.#####.#########.###########################.###.###########.#.###########################################.#.###.#########.#.#.#####.#.#.###.###
#.#.#.#.....#.........#...#...#...#.###########################.#.............#.#.###########################################.#.....#######...#...#.....#.#.....#.#
#.#.###.###.###.#######.#.###.#.#.#.###########################.###############.#.###########################################.#############.#####.#.#####.#########
#.......#.#.#...#.....#.#.###...#.#.###########################...............#.#.###########################################.###########...#...#...#...#.#.#.....#
#.#######.#.#####.###.###.#######.#.#########################################.#.#.###########################################.###########.###.#######.###.#.#.#####
#.#.......#.#.....###.#...#...#...#.#########################################.#.#.###########################################.#########...#.#.#...#.#.....#.......#
###.#.###.#.#.#######.#.#.###.###.#.#########################################.#.#.###########################################.#########.###.#.#.#.#.#.#######.#####
#...#.#...#...#...#.#.#.#.#...#...#.###################################.......#.#.###########################################...........#.......#.....#.......#...#
#.#.#####.#######.#.#.###.#.###.###.###################################.#########.#########################################################.###############.#.#.###
#.#.#...#.#...#...#.#.....#...#.#...###################################...........#############################################.......#...#.#...............#.#...#
#.###.#.#.###.#.#.#.#######.###.#.###################################################################################################.#.#.#.###.#############.#.###
#.....#.#.....#.#.#...#...#.....#.#############################################################################################.......#.#.#.....#.........###.....#
###.###.#######.#.###.###.#####.#.#############################################################################################.#######.#.#########.#####.#####.###
#...#.#.........#.#.#.#...#.......#############################################################################################.........#.......#...#...#.........#
###.#.###.###.###.#.#.###.#.#############################################################################################################.#####.#.#.###.#.#####.###
#...#.....#.....#...........#############################################################################################################.....#...#.....#.....#...#
###################################################################################################################################################################