######################y###
#.........#.#.#.....#....#
#####.#.###.#.#.#.#.###..#
#.#...#.#.......#.#...#..#
#.###.###.#.###########..#
#...#.....#.#.#.#........#
#.#.#.#.###.#.#.#####.##.#
#.#.#.#.#....#...#.#.#.#.#
#.#####.###..#.#.###...#.#
#.#.........#...#....#...#
#.#.###.#.#.###.##.#####.#
#.#.#.#.#.#.#.#..#...#...#
#.###.#.#####.#.#...##.###
#.....#...#...#.#....#...#
#.#.###.#####.##.###.#.###
#.#......................#
###x######################