#x################################
#...#...#........................#
#.#...#.#.########...#############
#...#...#...#...#.#..#############
#.#...#.#.#.#.#.#..#..############
#...#...#.#...#.#...#..###########
#######.#######.#....#..##.......#
#.......#.......#.....#..#..##..##
#.#######.......#....#..#..#...#.#
#.#.............#..#..#..#....#..#
#.#.#####.......#...#..#.....#...#
#.#.....#.......#..#..#.....#....#
#.#####.#.......#.#..#....#......#
#.......#.......#....#...........y
##################################