#####x#############
#.......#.........#
#.#.###...........#
#...#...#########.#
#.#...##......#...#
#...#.#..#..#...###
#.#.#.#.##.#.#.#..y
#.....##.....#.#.##
###...#.#####.....#
#.....#......#.#..#
#.....#......#.#.##
#.......#....#.#.##
#.....#......#.#.##
#.....#......#.#.##
###################