#x#.#..##.........#
#.......#......#..#
#...#...#.........#
#...#...#.........#
#####.#.#.........#
##....#.#......#.##
##..#.............#
##########....#.#.#
#..........#......#
...#.#.#...#......#
#########..#.....##
################y##