####################################################
y..#...............................................#
##.#...............................................#
#...#..............................................#
#..................................................#
#..................................................#
#..................................................#
x..................................................#
#..................................................#
#..................................................#
#..................................................#
#..................................................#
#..................................................#
#..................................................#
#..................................................#
#..................................................#
#..................................................#
#..................................................#
#..................................................#
#..................................................#
#..................................................#
#..................................................#
#..................................................#
#..................................................#
#..................................................#
#..................................................#
#..................................................#
#..................................................#
#..................................................#
#..................................................#
#..................................................#
#..................................................#
#..................................................#
#..................................................#
#..................................................#
#..................................................#
#..................................................#
#..................................................#
#..................................................#
#..................................................#
#..................................................#
#..................................................#
#..................................................#
#..................................................#
#..................................................#
#..................................................#
#..................................................#
#..................................................#
#..................................................#
#..................................................#
#..................................................#
#..................................................#
#..................................................#
#..................................................#
#..................................................#
#..................................................#
#..................................................#
#..................................................#
#..................................................#
#..................................................#
#..................................................#
#..................................................#
#..................................................#
####################################################
